12 12 12 12 12 12 12 12 12 12 12 12 12 12 12 12 12 12 12 12 12 12 12 12 12 12 12 12 13 12 12 12 12 12 12 12 13 12 12 12 12 12 12 13 12 12 12 12 12 12
12 12 13 12 12 12 12 12 12 12 12 12 12 12 13 12 12 12 12 12 13 12 12 12 12 12 12 12 12 12 12 12 12 12 12 12 12 12 12 12 12 12 12 12 12 12 13 12 12 12
12 12 12 12 12 12 12 13 12 12 12 12 12 12 12 13 12 12 12 12 12 12 12 12 12 13 12 12 12 12 13 12 12 13 12 12 12 12 12 12 13 12 12 12 12 12 12 12 12 13
12 12 12 12 13 12 12 12 12 12 13 13 12 12 12 12 12 12 13 12 13 12 12 12 12 12 12 13 12 12 12 12 12 12 12 12 12 12 12 12 12 13 12 13 12 12 12 12 12 12
12 12 12 13 12 13 12 12 12 13 12 12 12 12 12 13 12 12 12 12 12 12 12 13 12 12 12 12 12 12 12 13 12 12 13 12 12 12 13 12 12 12 12 12 12 12 12 12 12 12
12 13 12 12 12 12 12 12 12 12 12 12 12 12 12 12 12 12 13 12 12 13 12 12 12 12 12 12 12 13 12 12 12 12 12 12 13 12 12 12 13 13 12 13 12 12 12 12 13 12
12 12 12 12 12 13 22 20 20 20 20 20 20 20 23 13 12 12 22 20 20 20 20 20 20 20 20 23 12 12 12 22 20 20 20 20 20 20 20 20 20 20 23 12 12 12 12 13 12 12
12 12 12 12 12 12 18 11 10 45 11 65 10 11 19 20 20 20 21 41 11 10 11 10 10 11 11 19 20 20 20 21 41 11 57 33 33 55 33 33 33 58 17 12 12 13 12 12 12 12
12 12 13 12 12 12 18 11 40 40 40 40 40 10 41 41 41 41 41 41 10 14 15 15 15 16 11 41 41 41 41 41 41 41 31 26 26 26 26 26 26 30 17 12 12 12 12 12 12 12
12 12 12 12 12 12 18 66 40 39 39 39 40 11 41 41 11 41 41 44 66 17 12 12 12 18 10 41 41 41 41 41 11 41 53 26 26 26 26 26 26 52 17 12 12 12 12 12 12 12
12 13 12 13 12 12 18 10 40 39 39 39 40 11 41 44 44 42 44 41 10 17 12 12 12 18 11 41 41 11 41 41 41 41 53 26 26 26 26 26 26 52 17 12 13 12 12 12 12 12
12 12 12 12 13 12 18 11 40 39 39 39 40 10 11 41 45 44 11 41 11 19 20 20 20 21 10 41 41 43 41 43 41 43 31 26 26 26 26 26 26 30 17 12 12 12 13 12 13 12
12 12 12 12 12 13 18 10 40 40 39 40 40 11 41 44 45 44 42 44 11 65 35 33 64 11 63 10 10 11 10 10 11 10 37 28 50 29 26 49 28 60 17 13 12 12 12 12 12 12
12 12 12 12 12 12 18 11 66 10 11 10 11 11 41 43 43 66 44 43 41 41 31 26 30 41 46 44 44 41 42 42 41 46 46 41 42 31 26 30 14 15 25 12 12 12 12 12 12 13
12 12 13 12 13 12 18 46 45 46 11 46 42 42 41 43 43 42 43 45 11 44 53 26 30 41 45 42 46 45 46 46 46 46 61 46 42 53 26 52 17 12 12 12 12 13 12 12 12 12
12 12 12 12 12 12 24 15 16 43 10 41 43 46 42 45 11 43 45 45 43 41 31 26 52 41 41 41 41 46 43 11 45 45 45 44 65 53 26 30 17 12 12 12 12 12 12 12 12 12
12 12 12 12 12 12 13 12 18 41 11 46 43 41 43 44 44 43 45 44 44 43 53 26 52 11 11 61 41 44 46 46 46 46 44 41 41 31 26 30 17 12 13 12 12 12 13 12 12 12
12 12 13 12 12 12 12 22 21 45 10 44 11 43 43 61 43 43 43 11 41 43 53 26 30 42 45 41 41 44 45 46 46 44 44 62 33 56 26 52 17 12 12 13 12 12 12 12 12 12
12 12 12 12 12 13 12 18 11 10 11 41 44 45 44 41 43 41 44 41 43 43 31 26 52 46 43 42 41 42 46 45 46 41 11 31 26 26 26 52 17 12 12 12 12 12 12 12 12 12
12 12 12 13 12 13 12 18 10 44 44 44 45 45 44 45 11 65 41 41 43 65 31 26 30 11 41 41 46 46 46 45 45 41 41 53 26 27 50 60 17 12 13 12 12 12 12 12 13 12
12 12 13 12 12 12 12 18 10 44 11 44 10 57 33 55 33 55 33 33 55 33 56 26 54 33 33 33 55 33 33 33 33 55 33 34 26 52 11 45 17 12 12 12 12 12 12 12 12 12
12 12 12 12 12 13 12 18 11 41 44 41 11 53 26 26 26 26 26 26 26 26 26 26 26 26 26 26 26 26 26 26 26 26 26 26 26 30 10 14 25 12 12 12 12 13 12 12 12 12
13 13 12 13 12 12 13 18 11 11 42 44 10 59 28 50 28 28 50 50 28 28 51 26 49 28 50 28 50 50 28 50 28 28 50 29 26 52 11 17 12 13 12 12 12 12 12 12 12 12
12 12 13 12 12 12 12 24 16 10 43 11 10 46 42 41 11 46 41 11 11 66 31 26 30 65 45 11 42 42 45 45 43 45 45 31 26 30 65 17 12 12 12 12 13 12 12 12 13 12
12 12 12 12 12 12 12 12 18 11 41 41 11 41 46 42 41 46 41 11 11 44 31 26 52 41 41 46 46 11 41 46 43 45 45 53 26 30 11 17 12 12 12 12 12 12 12 12 12 12
12 12 12 12 12 13 12 22 21 10 42 43 10 11 66 41 44 46 44 41 44 44 53 26 30 43 44 44 46 65 44 46 11 46 41 31 26 52 10 17 12 12 12 13 13 12 12 12 12 12
12 12 13 12 12 12 12 18 11 10 46 43 42 11 10 11 44 42 11 41 46 42 31 26 30 42 42 46 41 41 46 43 46 41 45 53 26 30 62 17 12 12 12 12 12 12 12 12 12 12
12 12 12 13 12 12 12 18 10 41 43 11 46 42 11 41 42 41 46 11 46 42 53 26 52 41 42 11 41 46 46 43 45 65 41 31 26 52 11 17 12 13 12 12 12 12 12 12 12 12
12 12 12 12 12 12 12 18 11 43 11 43 42 42 10 41 11 41 44 46 41 41 31 26 52 45 45 46 44 41 11 42 43 43 46 31 26 30 65 17 12 12 12 12 12 12 12 12 12 12
12 12 12 12 12 12 13 18 10 10 10 10 11 10 11 41 43 41 42 42 11 42 31 26 52 65 45 41 45 41 65 42 10 45 41 37 50 60 11 17 13 12 12 12 13 12 12 12 12 12
12 12 12 12 12 12 12 18 66 10 63 11 10 66 10 42 42 11 42 42 42 42 53 26 30 42 42 45 46 45 45 46 43 41 43 43 10 42 14 25 12 12 13 12 12 12 12 13 12 12
12 13 12 12 12 12 12 24 16 10 10 11 46 10 10 10 43 43 43 41 11 46 31 26 52 41 44 11 41 45 43 45 41 41 44 10 10 42 17 12 12 12 12 12 12 12 12 12 12 12
12 12 12 12 12 13 12 12 18 10 11 10 10 11 10 11 43 45 45 41 46 41 53 26 52 41 11 45 42 43 43 43 65 43 46 66 11 10 17 12 12 12 12 12 12 13 13 12 12 12
12 12 12 12 12 12 12 12 18 11 10 66 11 10 10 41 43 45 11 43 41 11 53 26 30 11 45 46 46 43 10 11 46 44 41 10 10 11 17 12 12 13 12 12 12 12 12 12 12 12
12 12 12 12 12 12 13 12 18 66 10 10 10 10 67 41 46 45 65 46 46 41 31 26 30 41 41 42 41 44 45 42 11 44 42 10 10 10 17 13 12 12 12 12 12 12 12 12 12 12
12 12 12 12 13 12 12 22 21 46 42 10 41 46 44 44 46 42 45 41 43 41 59 28 60 41 11 41 45 45 46 44 42 42 41 11 11 10 19 23 12 12 13 12 12 12 12 12 12 12
12 13 12 12 12 12 12 18 11 46 43 43 44 46 11 41 43 11 41 10 10 11 10 10 10 11 10 65 43 41 41 41 42 41 11 10 11 67 45 19 23 12 12 12 13 12 12 12 12 12
12 12 12 12 12 12 13 18 46 41 46 43 11 66 44 42 43 42 10 63 10 11 66 11 10 10 62 10 41 41 11 41 42 11 45 10 10 10 11 66 17 12 12 12 12 12 12 12 12 12
12 12 12 12 12 12 12 18 10 41 11 41 41 41 42 10 11 10 10 11 10 10 10 10 10 11 10 10 41 44 45 41 10 10 11 62 10 11 10 10 17 12 13 12 12 12 12 12 12 12
12 13 12 12 13 12 12 18 63 41 42 41 42 10 11 10 41 41 11 10 11 10 10 11 11 63 10 67 10 41 41 11 10 11 10 11 10 44 43 10 17 12 12 12 12 12 12 12 12 12
12 12 13 12 12 12 12 18 11 41 48 11 10 11 41 41 41 41 10 66 10 10 10 10 10 10 10 10 11 10 10 63 10 10 44 10 11 10 11 10 17 12 13 12 12 13 12 12 12 12
12 12 12 12 12 12 12 18 11 41 41 41 41 66 41 14 15 15 16 10 11 66 10 10 65 10 10 14 15 15 16 10 11 10 10 10 10 67 11 10 17 12 12 12 12 12 12 13 12 12
12 12 12 12 12 12 12 18 41 41 41 41 41 41 14 25 12 12 24 16 10 10 10 11 10 45 14 25 12 12 18 10 66 41 65 11 44 10 10 66 17 12 12 12 13 12 12 12 12 12
12 13 12 12 13 12 12 24 15 15 15 15 15 15 25 13 12 12 13 24 15 15 15 15 15 15 25 12 13 12 24 16 10 11 10 10 10 11 14 15 25 12 13 12 13 12 12 12 12 12
12 12 12 12 12 12 12 13 12 12 12 12 12 12 12 12 12 12 13 12 12 12 13 12 12 12 12 13 12 12 12 24 15 15 15 15 15 15 25 12 13 12 12 12 12 12 13 12 12 12
12 12 12 12 12 12 12 12 12 12 12 13 12 12 12 12 13 12 12 12 12 12 12 13 12 12 12 12 12 12 12 12 12 12 13 12 13 12 12 12 12 12 12 13 12 12 12 12 12 12
12 12 12 12 12 12 13 12 12 12 12 12 12 12 12 12 12 12 12 12 12 12 12 12 13 12 12 12 12 13 12 12 12 12 12 12 12 12 12 12 12 12 12 12 12 12 12 12 12 12
12 12 13 12 12 12 12 12 12 12 13 13 12 12 13 12 12 12 12 12 13 12 12 12 12 12 12 12 12 12 12 12 13 12 12 13 12 12 12 13 12 12 12 12 12 12 12 12 12 12
12 12 12 12 12 13 13 12 12 12 12 12 12 13 12 12 12 12 12 12 12 12 12 12 13 12 12 13 12 12 12 12 12 12 12 12 12 12 12 12 12 12 12 12 12 13 12 12 13 12
12 12 12 12 12 12 12 12 12 12 12 12 12 12 12 12 12 12 13 12 12 12 12 12 12 12 12 12 12 12 13 12 12 12 12 12 13 12 12 12 12 12 12 12 12 12 12 12 12 12